border_size=1
usage=map

Mm          , Mm          , Mm          , Mm          , Mm          , Mm          , Gs^Fp       , Mm          , Hh          , Mm          , Re          , Ww          , Gg          , Ww          , Ww          , Ww          , Ww          , Mm          , Mm          , Mm          , Mm          , Mm          , Mm          , Mm          , Mm^Xm       , Mm          , Mm^Xm       , Mm          , Mm          
Mm          , Mm          , Mm          , Mm          , Mm          , Mm          , Gs^Fp       , Gs^Fp       , Hh          , Hh          , Rp          , Re          , 1 Gg        , Chr         , Ww^Bw/      , Ww          , Ww          , Mm          , Mm          , Mm          , Mm          , Mm          , Mm          , Mm          , Mm          , Mm^Xm       , Mm          , Mm^Xm       , Mm          
Mm          , Mm          , Mm          , Mm          , Mm          , Gs^Fp       , Gs^Fp       , Khr         , Chr         , Hh          , Gg          , Re          , Rp          , Re          , Ww          , Ww^Bw\      , Ww^Bw\      , Rp          , Chr         , Gg          , Gg          , Gg          , Hh          , Gg          , Mm^Xm       , Mm^Xm       , Mm          , Mm^Xm       , Mm          
Mm          , Mm          , Mm          , Mm          , Mm          , Gs^Fp       , Gs^Fp       , Chr         , Hh          , Hh          , Hh          , Rp          , Gg          , Ww          , Ww          , Ww          , Chr         , Re          , Rp          , Gg          , Gg          , Hh          , Gs^Fp       , Mm^Xm       , Mm^Xm       , Mm^Xm       , 3 Khr       , Mm^Xm       , Mm          
Mm          , Mm          , Mm          , Mm          , Mm          , Mm          , Mm          , Mm          , Hh          , Hh          , Gs^Fp       , Gg          , Ss          , Ww          , Ww          , Gg          , Gg          , Re          , Re          , Gg          , Gg          , Hh          , Hh^Vhh      , Gs^Fp       , Mm^Xm       , Chr         , Chr         , Chr         , Mm          
Mm          , Mm          , Mm          , Mm          , Mm          , Mm          , Hh^Vhh      , Mm          , Hh          , Hh          , Gs^Fp       , Gs^Fp       , Ss          , Ww          , Ww          , Ss          , Gg          , Re          , Re          , Gg          , Hh          , Hh          , Gs^Fp       , Mm          , Mm^Xm       , Chr         , Chr         , Mm^Xm       , Mm          
Mm          , Mm          , Mm          , Mm          , Mm          , Mm          , Mm          , Hh          , Mm          , Hh          , Gs^Fp       , Gs^Fp       , Gg          , Ss          , Ww          , Ww          , Gg          , Re          , Rp          , Gg          , Hh          , Hh          , Gs^Fp       , Mm^Xm       , Mm          , Chr         , Mm^Xm       , Mm^Xm       , Mm          
Mm          , Mm          , Mm          , Mm          , Mm          , Mm          , Mm          , Hh          , Mm          , Gs^Fp       , Gs^Fp       , Mm          , Ss          , Ss          , Ww          , Ww          , Re          , Re          , Hh          , Hh          , Hh          , Hh          , Mm          , Mm          , Mm^Vhh      , Mm          , Mm          , Mm^Xm       , Mm          
Mm          , Mm          , Mm          , Mm          , Mm          , Mm          , Mm          , Hh          , Hh          , Gs^Fp       , Mm          , Mm          , Ww          , Ww          , Ww          , Ww          , Re          , Hh          , Hh          , Hh          , Gs^Fp       , Gs^Fp       , Mm          , Mm          , Mm          , Mm          , Mm          , Mm          , Mm          
Mm          , Mm          , Mm          , Mm          , Mm          , Mm          , Hh          , Mm          , Gs^Fp       , Gs^Fp       , Gs^Fp       , Gg          , Ww          , Ww          , Ww          , Ss          , Re          , Re          , Hh          , Gs^Fp       , Mm          , Mm          , Mm          , Mm          , Mm          , Mm          , Mm          , Mm^Vhh      , Mm          
Mm          , Mm          , Mm          , Mm          , Mm          , Mm          , Mm          , Hh          , Mm          , Mm          , Gg          , Gg          , Ww          , Ww          , Ww          , Ss          , Re          , Hh          , Hh          , Gs^Fp       , Mm          , Mm          , Mm          , Mm          , Mm          , Mm          , Mm          , Mm          , Mm          
Ww          , Ww          , Ww          , Mm          , Mm          , Mm          , Mm          , Hh          , Mm          , Hh          , Gg          , Ww          , Ww          , Ww          , Ww          , Ss          , Re          , Re          , Hh          , Gs^Fp       , Hh          , Mm          , Mm          , Mm          , Mm          , Mm          , Mm          , Mm          , Mm          
Mm          , Mm          , Mm          , Ww          , Ww          , Mm          , Ww          , Gs^Fp       , Mm          , Hh          , Gg          , Ww          , Ww          , Ww          , Ww          , Gg          , Re          , Re          , Hh          , Gs^Fp       , Gs^Fp       , Mm          , Mm          , Mm          , Mm          , Mm          , Mm          , Mm          , Mm          
Mm          , Mm          , Mm          , Mm          , Mm          , Ww          , Hh          , Ww          , Ww          , Ww          , Ww          , Ww          , Hh          , Ww          , Gg          , Gg          , Re          , Rp          , Hh          , Hh          , Hh          , Gs^Fp       , Mm          , Mm          , Mm          , Mm          , Mm          , Mm          , Mm          
Mm          , Mm          , Mm          , Hh          , Mm          , Hh          , Hh          , Gs^Fp       , Gs^Fp       , Ww          , Ww          , Gs^Fp       , Wo          , Ww          , Gg          , Gg          , Re          , Rp          , Gg          , Hh          , Hh          , Gs^Fp       , Mm          , Mm          , Mm          , Mm          , Mm          , Mm          , Mm          
Mm          , Mm          , Mm          , Mm          , Mm          , Hh          , Mm          , Mm          , Gs^Fp       , Gg          , Ww          , Wo          , Wo          , Ww          , Gg          , Gg          , Rp          , Re          , Gg          , Hh          , Hh          , Hh          , Mm          , Mm          , Mm          , Mm          , Mm          , Mm          , Mm          
Mm          , Mm          , Mm          , Mm          , Mm          , Mm          , Mm          , Hh          , Gs^Fp       , Hh          , Ww          , Ww          , Wo          , Ww          , Ss          , Gg          , Gg          , Re          , Gg          , Hh          , Hh          , Hh          , Mm          , Mm          , Mm          , Mm          , Mm          , Mm          , Mm          
Mm          , Mm          , Mm          , Mm          , Mm          , Mm          , Mm          , Hh          , Hh          , Gs^Fp       , Gg          , Ww          , Wo          , Ww          , Khr         , Ss          , Ww          , Gg          , Gg          , Hh          , Hh          , Hh          , Mm          , Mm          , Mm          , Mm          , Mm          , Mm          , Mm          
Mm          , Mm          , Mm          , Mm          , Mm          , Mm          , Mm          , Gg          , Gg          , Gg          , Gg          , Ww          , Wo          , Wo          , Wo          , Chr         , Ss          , Ss          , Khr         , Gg          , Gg          , Mm          , Mm          , Mm          , Mm          , Mm          , Mm          , Mm          , Mm          
Mm          , Mm          , Mm          , Mm          , Mm          , Mm          , Mm          , Mm          , Gg          , Gg          , Khr         , Ww          , Ww          , Wo          , Ww^Bw/      , Wo^Bw/      , Wo          , Chr         , Ww          , Ss          , Gg          , Gg          , Gs          , Mm          , Gs^Fp       , Mm          , Mm          , Mm          , Mm          
Xu          , Xu          , Xu          , Mm          , Mm          , Mm          , Hh          , Mm          , Gg          , Gg          , Gg          , Chr         , Gg          , Ww^Bw/      , Chr         , Ww          , Ww          , Ww          , Ww          , Ss          , Gg          , Gg          , Gs          , Gs^Fp       , Gs^Fp       , Hh          , Hh          , Mm          , Mm          
Xu          , Xu          , 2 Kud       , Xu          , Xu          , Mm          , Hh          , Gg          , Gg          , Gg          , Gg          , Gg          , Re          , Gg^Vh       , Khr         , Ss          , Ww          , Ww          , Ww          , Ww          , Gg          , Gg          , Gg          , Gs^Fp       , Gs^Fp       , Hh          , Hh          , Mm          , Mm          
Uu          , Cud         , Cud         , Cud         , Uu          , Xu          , Gg          , Gg          , Gg          , Gg          , Re          , Re          , Rp          , Gg          , Gg          , Ss          , Ss          , Ww          , Ww          , Ww          , Gg          , Gg          , Gg          , Gs          , Gs^Fp       , Gs^Fp       , Hh          , Mm          , Mm          
Xu          , Cud         , Cud         , Cud         , Xu          , Uu^Ii       , Gg          , Gg          , Re          , Re          , Rp          , Gg          , Gg          , Gg          , Gg          , Ss          , Ss          , Ww          , Ww          , Ww          , Gg          , Gg          , Gg          , Gg          , Gs^Fp       , Hh          , Hh          , Mm          , Mm          
Xu          , Uu^Uf       , Uu^Vu       , Uu^Vu       , Uu^Vu       , Xu          , Xu          , Re          , Re          , Re          , Gg          , Gg          , Gg          , Gg          , Gg          , Gg          , Gg          , Ww          , Ww          , Ww          , Wwf         , Gg          , Gg          , Gs          , Gs^Fp       , Hh          , Gs^Fp       , Mm          , Mm          
Xu          , Xu          , Xu          , Xu          , Xu          , Mm          , Rp          , Re          , Rp          , Gg          , Gg          , Gg          , Ss          , Gg          , Ww          , Ww          , Ww          , Ww          , Ww          , Ww          , Wwf         , Gg          , Gs          , Gs          , Gs^Fp       , Hh          , Gs^Fp       , Mm          , Mm          
Mm          , Xu          , Mm          , Xu          , Mm          , Mm          , Re          , Re          , Gg          , Gg          , Ss          , Ss          , Ww          , Ww          , Ww          , Ww          , Ww          , Ss          , Ss^Vhs      , Ww          , Wwf         , Gg          , Gs^Fp       , Gs^Fp       , Gs^Fp       , Hh          , Mm          , Mm          , Mm          
Mm          , Mm          , Gs^Fp       , Mm          , Hh          , Rp          , Re          , Gg          , Gg          , Gg          , Ss          , Ww          , Ww          , Ww          , Ss          , Ww          , Ss          , Ss          , Ss          , Ss          , Gg          , Gs          , Gs^Fp       , Gs^Fp       , Gs^Fp       , Gs^Fp       , Gs^Fp       , Mm          , Mm          
Mm          , Mm          , Gs^Fp       , Gs^Fp       , Hh          , Re          , Rp          , Gg          , Gg          , Ss          , Ww          , Ww          , Ww          , Ss          , Ss^Vhs      , Ss          , Ss          , Ss          , Gg          , Gg          , Gg          , Gs          , Gs^Fp       , Gs^Fp       , Gs          , Hh          , Gs^Fp       , Mm          , Mm          
Mm          , Mm          , Gs^Fp       , Mm          , Hh          , Re          , Rp          , Gg          , Gg          , Gg          , Ww          , Ww          , Ww          , Ss          , Ss          , Ss          , Ss          , Gg          , Gg          , Gg          , Gg          , Gs^Fp       , Gs^Fp       , Gs^Fp       , Hh          , Hh          , Hh          , Mm          , Mm          
Mm          , Mm          , Mm          , Hh          , Hh          , Re          , Re          , Gg          , Gg          , Gg          , Ss          , Ww          , Ww          , Ss^Vhs      , Gg          , Ss          , Gg          , Gg          , Hh          , Gg          , Gs          , Gs^Fp       , Gs^Fp       , Gs^Fp       , Hh          , Gs^Fp       , Hh          , Mm          , Mm          
Mm          , Mm          , Gs^Fp       , Hh          , Hh          , Gg          , Rp          , Re          , Gg          , Gg          , Gg          , Ss          , Ss          , Ww          , Ww          , Ss          , Gg          , Gg          , Hh          , Hh          , Gs          , Gs^Fp       , Hh          , Hh          , Hh          , Hh          , Mm          , Mm          , Mm          
Mm          , Mm          , Mm          , Gs^Fp       , Hh          , Gg          , Re          , Re          , Gg          , Gg          , Gg          , Gg          , Ss          , Ww          , Ww          , Ww          , Ww          , Gg          , Gg          , Hh          , Hh          , Hh          , Hh          , Gs^Fp       , Gs^Fp       , Hh          , Mm          , Mm          , Mm          
Mm          , Mm          , Gs^Fp       , Hh          , Hh          , Gg          , Re          , Re          , Rp          , Gg          , Gg          , Gg          , Gg          , Wwf         , Wwf         , Ww          , Ww          , Ww          , Ww          , Gg          , Gg          , Hh          , Hh          , Gs^Fp       , Hh          , Mm          , Mm          , Mm          , Mm          
Mm          , Mm          , Mm          , Gs^Fp       , Hh          , Hh          , Gs^Fp       , Re          , Re          , Re          , Re          , Gg          , Gg          , Gg          , Gg          , Ww          , Ww          , Ww          , Ww          , Ww          , Ss          , Ss          , Hh          , Hh          , Gs^Fp       , Hh          , Mm          , Mm          , Mm          
Mm          , Mm          , Mm          , Gs^Fp       , Hh^Vhh      , Hh          , Hh          , Gs^Fp       , Gs^Fp       , Rp          , Rp          , Re          , Re          , Gg          , Gg          , Gg          , Ss          , Ww          , Ww          , Ww          , Ww          , Ss          , Hh          , Gs^Fp       , Gs^Fp       , Gs^Fp       , Mm          , Mm          , Mm          
Mm^Xm       , Mm          , Mm          , Mm          , Mm          , Hh          , Hh          , Gs^Fp       , Gs^Fp       , Gs^Fp       , Gs^Fp       , Rp          , Re          , Rp          , Rp          , Gg          , Gg          , Ss          , Ss^Vhs      , Ww          , Ww          , Ss          , Ss          , Hh          , Hh          , Mm          , Mm          , Mm          , Mm          
Mm^Xm       , Mm^Xm       , Mm^Xm       , Mm          , Mm          , Mm          , Mm          , Mm          , Hh          , Mm          , Hh          , Hh          , Hh          , Re          , Re          , Rp          , Hh          , Ss          , Ss          , Ww          , Ww          , Wwf         , Mm          , Mm          , Mm          , Mm          , Mm          , Mm          , Mm          
Mm^Xm       , Mm^Xm       , Mm^Xm       , Mm          , Mm          , Mm          , Mm          , Mm          , Hh          , Mm          , Mm          , Mm          , Mm          , Hh          , Rp          , Rp          , Hh          , Ss          , Ss          , Ww          , Ww          , Wwf         , Ww          , Mm          , Mm          , Mm          , Mm          , Mm          , Mm          


