border_size=1
usage=map

Hh          , Hh          , Hh          , Hh          , Gs^Fp       , Hh          , Hh          , Hh          , Gg          , Re          , Rp          , Rp          , Gg          , Hh          , Hh          , Mm          , Mm          , Mm          , Mm          , Mm          , Mm          , Mm          , Mm          , Mm          , Mm          , Hh          , Gs^Fp       , Hh          , Mm          
Hh          , Hh          , Gs^Fp       , Gs^Fp       , Gs^Fp       , Hh          , Gg          , Gg          , Gg          , Re          , Rp          , Gg          , Gg          , Hh          , Hh          , Mm          , Mm          , Mm          , Mm          , Mm          , Gs^Fp       , Mm          , Mm          , Mm          , Mm          , Gs^Fp       , Gs^Fp       , Mm          , Mm          
Hh          , Hh          , Ce          , Ce          , Ce          , Hh          , Gs^Fp       , Gg          , Gg          , Rp          , Rp          , Gg          , Gg          , Hh          , Hh          , Mm          , Mm          , Mm          , Mm          , Mm          , Mm          , Mm          , Hh          , Mm          , Ce          , Ce          , Ce          , Mm          , Mm          
Hh          , Hh          , Ce          , 1 Ke        , Ce          , Gs          , Gg          , Gg          , Gg          , Re          , Rp          , Re          , Gg          , Hh          , Hh          , Hh          , Hh          , Mm          , Mm          , Mm          , Mm          , Mm          , Hh          , Hh          , Ce          , 5 Ke        , Ce          , Gs          , Gs^Fp       
Gs^Fp       , Hh          , Gs^Fp       , Ce          , Gs          , Gs^Fp       , Gs^Fp       , Gg          , Gs^Fp       , Gg          , Re          , Rp          , Gg          , Gg          , Gg          , Hh          , Hh          , Mm          , Mm          , Mm          , Mm          , Mm          , Gs^Fp       , Hh          , Gs^Fp       , Ce          , Gs          , Gs^Fp       , Gs^Fp       
Gs^Fp       , Hh          , Gs^Fp       , Gs          , Gs          , Gs          , Gs^Fp       , Gs          , Gs^Fp       , Gg          , Re          , Rp          , Gg          , Gg          , Gg          , Hh          , Hh          , Hh          , Mm          , Mm          , Mm          , Mm          , Mm          , Hh          , Gs^Fp       , Gs          , Mm          , Mm          , Mm          
Gs^Fp       , Gs^Fp       , Gs^Fp       , Gs          , Gs^Fp       , Gs^Fp       , Gs^Fp       , Gs          , Gs          , Gs^Fp       , Re          , Rp          , Gg          , Gs^Fp       , Gs^Fp       , Gg          , Hh          , Hh          , Hh          , Mm          , Mm          , Mm          , Mm          , Mm          , Gs^Fp       , Gs          , Mm          , Mm          , Mm          
Gs^Fp       , Hh          , Gs^Fp       , Gg          , Gg          , Gs^Fp       , Gg          , Gg          , Gs^Fp       , Gs^Fp       , Re          , Re          , Gg          , Gs^Fp       , Gs^Fp       , Gg          , Gg          , Hh          , Hh          , Mm          , Mm          , Mm          , Mm          , Mm          , Mm          , Mm          , Mm          , Mm          , Gg          
Gs^Fp       , Hh          , Hh          , Gs^Fp       , Gg          , Gg          , Gg          , Gs          , Gg          , Gg          , Re          , Rp          , Rp          , Gg          , Gg          , Gg          , Gg          , Hh          , Hh          , Hh          , Hh          , Mm          , Mm          , Mm          , Mm          , Mm          , Mm          , Mm          , Gg          
Gs^Fp       , Hh          , Gs^Fp       , Gs^Fp       , Gg          , Gg          , Gg          , Gs^Fp       , Gs^Fp       , Gg          , Rp          , Re          , Ch          , Ch          , Ch          , Rp          , Gg          , Gg          , Gg          , Hh          , Hh          , Hh          , Gs^Fp       , Mm          , Gs^Fp       , Gs^Fp       , Gg          , Gg          , Gg          
Hh          , Hh          , Gg          , Gg          , Gg          , Gg          , Gg          , Gs^Fp       , Gs^Fp       , Gg          , Gg          , Rp          , Ch          , 6 Kh        , Ch          , Gg          , Gg          , Gs^Fp       , Gs^Fp       , Gs          , Gs          , Hh          , Hh          , Hh          , Gg          , Gg          , Gg          , Gg          , Gg          
Hh          , Hh          , Gs^Fp       , Gs          , Gs          , Gs          , Gg          , Gg          , Gs          , Gg          , Gg          , Rp          , Rp          , Ch          , Gg          , Gg          , Gg          , Gg          , Gs          , Gs^Fp       , Gs          , Hh          , Hh          , Hh          , Gs^Fp       , Gs          , Gs          , Gs          , Gg          
Hh          , Hh          , Hh          , Gs^Fp       , Gs^Fp       , Gs          , Gs^Fp       , Gs          , Gs          , Gg          , Gg          , Re          , Re          , Rp          , Gg          , Gg          , Gg          , Gg          , Gs^Fp       , Gs^Fp       , Gs^Fp       , Gg          , Hh          , Hh          , Hh          , Gs^Fp       , Gs^Fp       , Gs          , Gs^Fp       
Gs^Fp       , Gs^Fp       , Hh          , Gs^Fp       , Gs^Fp       , Gs^Fp       , Gs^Fp       , Gs^Fp       , Gs^Fp       , Gg          , Gg          , Gg          , Re          , Rp          , Gg          , Gg          , Gs          , Gg          , Gg          , Gs          , Gs^Fp       , Gs^Fp       , Gs^Fp       , Gs^Fp       , Hh          , Gs^Fp       , Gs^Fp       , Gs^Fp       , Ss          
Gs^Fp       , Gs^Fp       , Gs^Fp       , Gs^Fp       , Gs^Fp       , Gs^Fp       , Gs^Fp       , Gs^Fp       , Gs^Fp       , Gs          , Gg          , Gg          , Re          , Rp          , Gs^Fp       , Gs^Fp       , Gs^Fp       , Gs^Fp       , Gs^Fp       , Gs^Fp       , Gs^Fp       , Gs          , Gs^Fp       , Gs^Fp       , Ss          , Gs^Fp       , Ww          , Ww          , Ww          
Gs^Fp       , Gs^Fp       , Gs^Fp       , Gs^Fp       , Gs          , Gs          , Gs^Fp       , Gs^Fp       , Gs^Fp       , Gs^Fp       , Gg          , Rp          , Re          , Gg          , Ww          , Ss          , Ww          , Ww          , Ww          , Ww          , Ww          , Gs          , Ww          , Ww          , Ww          , Ww          , Gs          , Ss          , Gs^Fp       
Gs^Fp       , Gs^Fp       , Gs          , Gs          , Cv          , Gs          , Gs          , Gs^Fp       , Gs^Fp       , Gs^Fp       , Gs^Fp       , Gg          , Re          , Gg          , Ww          , Ww          , Gs^Fp       , Ww          , Gs^Fp       , Gs^Fp       , Gs^Fp       , Ww          , Gs^Fp       , Gs^Fp       , Gs          , Gs          , Cv          , Gs          , Gs          
Gs^Fp       , Gs^Fp       , Gs          , Cv          , 2 Kv        , Gs          , Gs          , Gs^Fp       , Gs^Fp       , Gs^Fp       , Gs^Fp       , Gg          , Re          , Ww^Bw/      , Ww          , Gs^Fp       , Gs^Fp       , Gs^Fp       , Gs^Fp       , Gs^Fp       , Gs^Fp       , Gs^Fp       , Gs^Fp       , Gs^Fp       , Gs          , Gs          , 4 Kv        , Gs          , Gs          
Gs^Fp       , Gs^Fp       , Gs^Fp       , Gs          , Gs          , Cv          , Gs          , Gs^Fp       , Gs^Fp       , Gs^Fp       , Gs^Fp       , Gg          , Re          , Gg          , Ww          , Gs^Fp       , Gs^Fp       , Gs^Fp       , Cv          , Gs^Fp       , Gs^Fp       , Gs^Fp       , Gs^Fp       , Gs^Fp       , Gs          , Kv          , Gs          , Cv          , Gs          
Gs^Fp       , Gs^Fp       , Gs^Fp       , Gs          , Gs^Fp       , Gs          , Gs^Fp       , Gs^Fp       , Gs^Fp       , Gs^Fp       , Gs          , Gg          , Re          , Gg          , Gs^Fp       , Gs^Fp       , Gs^Fp       , Cv          , 3 Kv        , Cv          , Gs^Fp       , Gs^Fp       , Gs^Fp       , Gs^Fp       , Gs^Fp       , Gs          , Gs^Fp       , Gs          , Gs^Fp       
Gs^Fp       , Gs^Fp       , Gs^Fp       , Gs^Fp       , Gs^Fp       , Gs^Fp       , Gs^Fp       , Gs^Fp       , Gs^Fp       , Gs^Fp       , Re          , Re          , Gg          , Gg          , Gs^Fp       , Gs^Fp       , Gs^Fp       , Gs^Fp       , Gs^Fp       , Gs^Fp       , Gs^Fp       , Gs^Fp       , Gs^Fp       , Gs^Fp       , Gs^Fp       , Gs^Fp       , Gs^Fp       , Gs^Fp       , Gs^Fp       
Gs          , Gs^Fp       , Gs^Fp       , Gs^Fp       , Gs^Fp       , Gs^Fp       , Gs^Fp       , Gs^Fp       , Gs          , Gs          , Re          , Gs          , Gg          , Gg          , Gs^Fp       , Gs^Fp       , Gs^Fp       , Gs^Fp       , Gs^Fp       , Gs^Fp       , Gs^Fp       , Gs^Fp       , Gs          , Gs^Fp       , Gs^Fp       , Gs^Fp       , Gs^Fp       , Gs^Fp       , Gs^Fp       

